{
  "id": "economic_expansion_30",
  "name": "经济扩张·30×30",
  "description": "4 人经济持久战：4 村落 + 2 佣兵站 + 1 关卡窄道，主打占领与金币运营",
  "biome": "grass",
  "size": 30,
  "chars": {
    "P": "plain",
    "F": "forest",
    "M": "mountain",
    "R": "river",
    "C": "castle",
    "v": "village",
    "b": "barracks",
    "r": "road",
    "g": "gate"
  },
  "layout": [
    "PPPPCCvvCCCCvCCCCCCvvCCCCCPPPP",
    "PPCrrCCCCCCCCCCCCCCCrrCCCCPPPP",
    "PPCrCCCCCCCCCCCCCCCCCbCCCCCPPP",
    "PPCrCCvCCPPFFPPCCCCCCCCCCPPPPP",
    "PCCrbCCCFPPFFFFPCCCCCCCCCCPPPP",
    "PCCCCCCCFPPPPPFFCCCCCCCCCCPPPP",
    "PCCCCCCCCPPFFFFCCCCCCCCCCCPPPP",
    "PCCCCCCCCPPPPPPCCCCCCCCCCCPPPP",
    "PPCvCCCCPPFFPFFCCCCCCCCCCCPPPP",
    "PPCCCCCPPPPFPPPMMMMCCCCCCPPPPP",
    "PPCCCCCPPFFPPPMMMMCCCCCCPPPPPP",
    "PPCCCCCCCCCCCPPFFCCCCCCCCPPPPP",
    "PPCCCCCCCCCCCPPFFCCCCCCCCPPPPP",
    "PPCCCCCCCCCCCPPFFCCCCCvvCCPPPP",
    "PPCvCCCCCCCCCCPFFFFFFFFCCPPPPP",
    "PPCCCCCCCCCCCCPPFFFFFFFFCCPPPP",
    "PPCCCCCCCCCCCCCPPFFFFCCCCPPPPP",
    "PPCCCCCCCCCCCCCCPPPPCgCCPPPPPP",
    "PPCCCCCCCCCCCCCCCCCPPgCCCPPPPP",
    "PPCCCCCbCCCCCCCCCCCCCgCCPPPPPP",
    "PPCCCCCCCCCCCCCCCCCPPPCPPPPPPP",
    "PPCCCCCCCCCCCCCCCPPPPPCPPPPPPP",
    "PPCCvCCCCCCCCCCCPPPPPMMCCPPPPP",
    "PCCCCCCCCCCCCCPPPPPMMCCCCPPPPP",
    "PCCCCCCCCCCCCCCPPPPPCvCCPPPPPP",
    "PCCCCCCCCCCCCCCPPCCCCCCCCPPPPP",
    "PCCvCCCCCCCCCCPCvCCCCCCCCPPPPP",
    "PCCCCCCCCCCCCCCCCCbCCCCCCPPPPP",
    "PPCrrCCCCCCCCCCCCrrCCCCCCPPPPP",
    "PPCCvvCCCCCCCCvCCCCvCCCCCPPPPP"
  ]
}