{
  "id": "fortress_35",
  "name": "城防·35×35",
  "description": "4 人城堡对决：4 城堡 + 关卡封锁 + 森林迷宫 + 中央道路慢推",
  "biome": "grass",
  "size": 35,
  "chars": {
    "P": "plain",
    "F": "forest",
    "M": "mountain",
    "R": "river",
    "C": "castle",
    "v": "village",
    "b": "barracks",
    "r": "road",
    "g": "gate"
  },
  "layout": [
    "CCvCCCCCCCCCCCCCCCCCCCCCCCCCCCCCCCC",
    "CCCCbCCPPCCCCCCCCCgCCCCCCCCCCCCCCCC",
    "CCCCCCPPCCCCCCCCCCCCCgCCCCCCCvCCCCC",
    "CCCCCCCCCCCCCCCCCCCCCCCCCgCCCCCCCCC",
    "CCvvCCCCCCCCCCCCCCCCCCCCCCCCCCCCCCC",
    "CCFFFFFFFFFFFFFFFCCCCCCbbCCCCCCCCCC",
    "CCCFFFFFFFFFFFFFFCCCCCCCCCvCCCCCCCC",
    "CCCCFFFFFFFFFFFFCCCCCCCCCCCCCCCCCCC",
    "PPCCCCCFFFFFFFFCCPPCCCCCCCCCCCCCCCC",
    "PPCCCCCCCCCCCCCCPPPPCvCCCCCCCCCCCCC",
    "PPFFCCCCCCCCCCCPPFFFCCCCCCCCCCCCCCC",
    "PPFFFFCCCCCCCFFPPFFFFFFFFFCCCCCCCCC",
    "PPFFFFCCCCCCCFFPPFFFFFFFFFFCCCCCCCC",
    "PPFFFFCCCCCCCFFPPFFFCCCCCCCCCCCCCCC",
    "PPFFCCCCCCCCCCCPPFFCCCCCCCCCCCCCCCC",
    "PPCCCCCCCCCCCCCCPPCCCCCCCCCvCCCCCCC",
    "PPCCCCCCCCCCCCCCCCCFFCCCCCbbCCCCCCC",
    "PPCCvCCCCCCCCCCCCFFFFFFFFFCCCCCCCCC",
    "PPPCCCCCCvvCCCCCCCFFFFFFFFFCCCCCCCC",
    "PPPPCCrrrrrrrrrrrrrrrCCCCCFCCCCCCCC",
    "PPPPPCrrrrrrrrrrrrrrrCCCCCFCCCCCCCC",
    "PPPPCCrrrrrrrrrrrrrrrCCCCCFCCCCCCCC",
    "PPCCvvCCCCCFFFFCCCCCCCCCCCCCCCCCCCC",
    "PCCCCCCCFFFFFFFFFFCCCCCCCCCCCCCCCCC",
    "PCCCCCCFFFFFFFFFFCCCCCCCCCvvCCCCCCC",
    "PCbbCCCFFFFFFFFFCCCCCbbCCCCCCCCCCCC",
    "PCCCCCFFFFFFFFFFCCCCCCCCCCCCCCCCCCC",
    "CCCCCCFFFFFFFFFFCCCCCCCCCCCCCCCCCCC",
    "CCCCCFFFFFFFFFFFCCCCCCCCCCCCCCCCCCC",
    "CCCCCFFFFFFFFFFFFCCCCCCCCCCCCCCCCCC",
    "CCvCCCCCCCCCCCCCCCCCvCCCCCCCCCCCCCC",
    "CCCCbCCCCCvCCCCCFFCCCCCvvCCCCCCCCCC",
    "CCCCCCCCCCCCCCCFFFFFFFFCCCCCCCCCCCC",
    "CCCCCCCCCCCCCCFFFFFFFFCCCCCCCCCCCCC",
    "CCCCCCCCCCCCCCCFFFFFFFFCCCCCCCCCCCC"
  ]
}