{
  "id": "free_for_all_45",
  "name": "大混战·45×45",
  "description": "4 人巨型混战：4 角兵 + 6 村落 + 4 佣兵站 + 2 关卡 + 道路网络 + 大量森林山脉掩体",
  "biome": "grass",
  "size": 45,
  "chars": {
    "P": "plain",
    "F": "forest",
    "M": "mountain",
    "R": "river",
    "C": "castle",
    "v": "village",
    "b": "barracks",
    "r": "road",
    "g": "gate"
  },
  "layout": [
    "CCvCCCCCCPPPPPPPPCCCCCCCCCCCCCCCCCCCCCCCCCCCC",
    "CCCCCCCPPCCCCCCCPPCCvvCCCCCCCCCFFCCCCCCCCCCCC",
    "CvbCCCCCPPCCCCCCPPCCCCCCCCCCCCFFFFFFFFCCCCCCC",
    "CCCCCCCCCFFCCCCPPFFCCCCCCCFFFCCCCCCCCFFFFCCCC",
    "CCFFCCCFFFFCCCCPPFFFFCCCCCCFFFFFFFFFFFFCCCCCC",
    "CCCFFCFFFFCCCCPPFFFFFFFFFCCCCCCCCCCCCCCCCCCCC",
    "CCCCCCCFFFFCCCPPFFFFFFFFCCCCCCCCvvCCCCCCCCCCC",
    "CCCCCCCCCCCFFCCPPFFFFCCCCCCCCCCCCCCCCCCCCCCCC",
    "CCCCCCCCCCCCCCrrrPPCCCCCCCCCCCCCCCbbCCCCCCCCC",
    "CCCCCCCCCCCCCrrrrrPPCCCCCCCCCCCCCCCCCCCCCCCCC",
    "CCCCCCCCCCCCrrrrrrrPPCCCCCCCCCCCCCFFFCCCCCCCC",
    "CCCCCCCCCCrrrrrrrrrPPCCCCCCCFFFFFFFFFCCCCCCCC",
    "CCCCCCCFFrrrrrrrrrrPPCCCCCCCFFFFFFFFCCCCCCCCC",
    "CCCCCCFFFFFFFFrrrrrrrPPCCCCCFFFFFFFFFCCCCCCCC",
    "CCCCCCCFFFFFFFrrrrrrPPCCCFFFFFFFFFFFFCCCCCCCC",
    "CCCCCCCCCCCFFFFrrrrrPPCCCCCFFFFFFFFFCCCCCCCCC",
    "CCCCCCCCCCCCCCrrrrrPPPCCCCCCFFFFFFFFFCCCCCCCC",
    "CCCCCCCCCCCCCrrPPPPPPCCCCCCCFFFFFFFFFCCCCCCCC",
    "CCCCCCCCCCCCCPPPPCCCCCCCCCCCFFFFFFFFFFCCCCCCC",
    "CCCCCCCCCCCPPCCCCCCFFCCCCCFFFFFFFFFFFCCCCCCCC",
    "CCCCCCCCCCCPPCCCCFFFFFFFFCCCFFFFFFFFFFCCCCCCC",
    "CCvCCCCCCPPPPCCCFFFFFFFFCCCCCFFFFFFFFFCCCCCCC",
    "CCCCCCCCCPPCCCCCCCFFFFFFFFCCCCCCCFFFFFCCCCCCC",
    "CCCFFCCCCCPPCCCCCFFFFFFFFCCCCCFFFFFFFFFCCCCCC",
    "CCCFFCCCCPPPCCCCFFFFFFFFCCCCCCCCFFFFFCCCCCCCC",
    "CCFFCCCCCPPCCCCCFFFFFFFCCCCCCCCCFFFFFFFFCCCCC",
    "CCCFFCCCCCPPCCCCFFFFFFFFCCCCCCCFFFFFFFCCCCCCC",
    "CCCCCCCCCCCPPCCCFFFFFFFFFCCCCCCCFFFFFFFCCCCCC",
    "CCCFFCCCCCPPPCCFFFFFFFFFCCCCCCCCCCFFFFFCCCCCC",
    "CCFFCCCCCPPPPCCCFFFFFFFFCCCCCCCCCFFFFFCCCCCCC",
    "CCCFFCCCCCPPCCCCCFFFFFFFFFCCCCCCCCCFFFCCCCCCC",
    "CCFFCCCCCPPCCCCCCFFFFFFFFCCCCCFFCCCCCCCCCCCCC",
    "CCFFCCCCCPPCCCCCCCFFFFFFFCCCFFFFCCCCCCCCCCCCC",
    "CCFFCCCCCPPCCCCCCCCFFFFFFFCCvFFFCCCCCCCCCCCCC",
    "CCFFCCCCCPPCCCCCCCCCFFFFFFFCCFFCCCCCbbCCCCCCC",
    "CCFFCCCCCgPPCCCCCCCCCCFFFFFFCFFFCCCCCCCCCCCCC",
    "CCCFFCCCCgPPCCCCCCCCCCCFFFFCCFFCCCCCCCCCCCCCC",
    "CCCCCFFFCgPPCCCCCCCCCCCCCCFFCCFFCCCCCCCCCCCCC",
    "CCCCCFFCCgPPCCCCCCCCCCCCCCFFCCFFCCCCCCCCCCCCC",
    "CCCCCFFFCgPCCCCCCCCCCCCCFFCCCFFCCCCCCCCCCCCCC",
    "CCCCCCCCCCPCCCCCCCCCCCFFCCCCCFFCCCCCCCCCCCCCC",
    "CCvvCCCCCCPPCCCCCCCCCCFFCCCCCFFCCCCCCCCCCCCCC",
    "CCCCCbCCCCPCCCCCCCCCCCFFCCCCCFFCCCCCCCCCCCCCC",
    "CCCCCCCCCCPPCCCCCCCCCCFFCCCCCFFCCCCCCCCCCCCCC",
    "CCCCCCCCCCPPCCCCCCCCCCFFCCCCCCCFFCCCCCCCCCCCC"
  ]
}