{
  "id": "three_way_25",
  "name": "三国混战·25×25",
  "description": "3 人三向开战：东 / 南 / 西各 1 城堡 + 1 佣兵站，森林迷宫阻隔，速战速决",
  "biome": "grass",
  "size": 25,
  "chars": {
    "P": "plain",
    "F": "forest",
    "M": "mountain",
    "R": "river",
    "C": "castle",
    "v": "village",
    "b": "barracks",
    "r": "road",
    "g": "gate"
  },
  "layout": [
    "PPPPCCCCCCCCvCCCCvCCCCCPP",
    "PCCvCCCCCCCCCCCCCCCCCvCPP",
    "CCCCCbbbbCCrbCCbbbCCCCCPP",
    "CCCCCCrCCCCCCCvCCCCCCCCPP",
    "PvCCCCCCCCCCCbCCCCCCvCCPP",
    "PCCCCCCvvCCCCCCCCCCCCCCPP",
    "PCCCCCCCCCCCCCCFFCCCCCCPP",
    "PPCCCCCCCCCCCFFCCCCCCCCPP",
    "PPCCFFCCCCCFFCCCCCFFFFFPP",
    "PPPCFFFFFFFFFFFFFFFFFCPPP",
    "PPPPFFFFFFFFFFFFFFFFPPPPP",
    "PPPPPFFFFFFFFFFFFFFFPPPPP",
    "PPPPPPFFFFFFFFFFFFPPPPPPP",
    "PPPPPPFFFFFFFFFFFFPPPPPPP",
    "PPPPPPFFFFFFFFFFFFPPPPPPP",
    "PPPPPPFFFFFFFFFFFFPPPPPPP",
    "PPPPPPPFFFFFFFFFFFPPPPPPP",
    "PPPPPPPPFFFFFFFFFPPPPPPPP",
    "PPPPPPPPFFFFFFFFFPPPPPPPP",
    "PPPPPPPPPFFFFFFFFPPPPPPPP",
    "PPPCFFFFFFFFFFCCCCCPPCPPP",
    "PPFFCCCCCFFCCCCCCCCCCCPPP",
    "PPCCCCCCCFFCCCCCvvCCCPPPP",
    "PCvCCCCCCCCCCbCCCCCCCPPPP",
    "PPCCvvCCCCCCCCCvCCCCCPPPP"
  ]
}