{
  "id": "throne_war_40",
  "name": "王座争夺·40×40",
  "description": "4 人王座争夺：四角落兵 + 中央河流+道路十字路口 + 大量森林遮蔽",
  "biome": "grass",
  "size": 40,
  "chars": {
    "P": "plain",
    "F": "forest",
    "M": "mountain",
    "R": "river",
    "C": "castle",
    "v": "village",
    "b": "barracks",
    "r": "road",
    "g": "gate"
  },
  "layout": [
    "CvCCCCCCPPPPPCCCCCCCCCCvCCCCCCCCCCCCCCCC",
    "CCCCCCCPPCCCCCPPCCCCCCCCCCCCCCCCCCCCCCCC",
    "CvvCCCCCCbCCCbCCCCCFFFFCCCCCCCCCCCCCCCCC",
    "CCCCCCCCCFFCCCFFCFFFFFFFFCCCCCCCCCCCCCCC",
    "CCCCCFFCCCFFCCCFFFFFFFFFFFCCCCCCCCCCCCCC",
    "CCCCCFFCCCFFCCCCCFFFMCCCCCCCCCCCCCCCCCCC",
    "CCCCCFFCFFFFFFFFCCMMMCCCCCFFCCCCCCCCCCCC",
    "CCCCCCCFFCCCCCCCCCMMMMCCCCCFFCCCCCCCCCCC",
    "CCCCCCCFFCCCCCCCCCCMMRCCCCCFFCCCCCCCCCCC",
    "CCCCCCFFCCCRRRRRCCCCCCCFFCCFFCCCCCCCCCCC",
    "CCCCCCCFFCRRrrRRCCCFFFFCCCCCCFFCCCCCCCCC",
    "CCCCCCCFFCRRrrRRCCCFFFFFFFFCCCCCCCCCCCCC",
    "CCCCCCCCCCRrrRRCCCCFFFFCCCCCCCCCCCCCCCCC",
    "CCCCCCCFFCRRrrRRCCCCFFFFFFFFCCCCCCCCCCCC",
    "CCCCCCCFFCRRrrRRCCCCCFFFFCCCCCCCCCCCCCCC",
    "CCCCCCCCFFRRRCCCCCCCFFFFCCCCCCCCCCCCCCCC",
    "CCCCCCCCCFFCCCCCFFFFFFFFFCCCCCCCCCCCCCCC",
    "CCCCCCCCCCCFFCCCCCFFFFCCCCCCCCCCCCCCCCCC",
    "CCCCCCCCCCCCCCCCCCCCCFFFFFFFFFCCCCCCCCCC",
    "CCCCCCCCCCFFCCCCCFFFFCCCCCCCCCCCCCCCCCCC",
    "CCCCCCCCCCFFCCCCCFFFFCCCCCCCCCCCCCCCCCCC",
    "CCCCCCCCCCCFFCCCCCFFFFCCCCCCCCCCCCCCCCCC",
    "CCCCCCCCCCFFCCCCCFFFFCCCCCCCCCCCCCCCCCCC",
    "CCCCCCCCCCFFCCCCCFFFFCCCCCCCCCCCCCCCCCCC",
    "CCCCCFFCCCCFFCCCCCFFFFCCCCCCCCCCCCCCCCCC",
    "CCCCCFFCCCCCFFCCCCCCFFCCFFCCCCCCCCCCCCCC",
    "CCCCCFFCCCCCFFCCCCCCCFFCCFFCCCCCCCCCCCCC",
    "CCCCCFFCCCCCCFFCCCCCFFFFCCCCCCCCCCCCCCCC",
    "CCCCCCFFCCCCCFFCFFFFFFFFCCCFFFCCCCCCCCCC",
    "CCCCCCCFFCCCCCCCFFFFCCCFFCCCCCCCCCCCCCCC",
    "CCCCCFFCCCCCvCCCCCCCFFCCCCCFFFCCCCCCCCCC",
    "CCCFFCbbCCCCCCCCCCFFCCCCCFFCCCCCCCCCCCCC",
    "CCFFCCCCCvCCCCCCCCCFFFFCCCCCCCCCCCCCCCCC",
    "CFFCCCCCFFCCCCCFFFFCCCCCCCCCCCCCCCCCCCCC",
    "CCFFCCCCCFFCCCCCCCCCCFFCCCCCCCCCCCCCCCCC",
    "CCCCCCCCCFFCCCCCFFCCCCCCCCCCCCCCCCCCCCCC",
    "CCCCCCCCCCFFCCCFFCCCCCvCCCCCCCCCCCCCCCCC",
    "CCCCCCCCCCCFFCCCFFCCCbCCCFFCCCCCCCCCCCCC",
    "CCCCCCCCCCCCCCCCCFFCCCCCFFCCCCCCCCCCCCCC",
    "CCCCCCCCCCCCCCCCCCCFFCCCCCFFCCCCCCCCCCCC"
  ]
}